1111111
1P...01
1000001
1111111
