11111111
1P000101
11000001
10001001
10001001
10101011
11111E11
11111111