111111111111111111111
1P0000000000000000001
100000C00000C0000001
100000000000000000001
100000C00000C0000001
100000000000000000001
100000000000000000001
100000000000000000001
100000000000000000001
100000000000000000001
100000000000000000001
100000000000000000001
100000000000000000001
100000000000000000001
100000000000000000001
100000000000000000001
100000000000000000001
100000000000000000001
100000000000000000001
10000000000000000000E
111111111111111111111
